0000000000000000000000000000000000000000
0000000000000000000000000000000000000000
0000000000000000000000000000000000000000
0000000000000000000000000000000000000000
0000000000000000000000000000000000000000
0000000000000000000000000000000000000000
0000000000000000000000000000000000000000
0000000000000000000000000000000000000000
0000000000000000000000000000000000000000
0000000000000000000000000000000000000000
0000000000000000000000000000000000000000
0000000000000000000000000000000000000000
0000000000000000000000000000000000000000
0000000000000000000000000000000000000000
0000000011111100000000000000000000000000
0000000011111133333300000000000000000000
0000000000000000000000000000000000000000
0000000000000000000000000000000000000000
0000000000000000000000001111111111110000
0000000000000000000000001111111111113330
0000000000000000000011111111111111000000
0000000000000000000011111111100000000000
0000000000000331111111111111100000000000
0000000000000001111111111111100000000000
0000000000000001100000000000000000000000
0000000000000001100000000000000000000000
0000000000000001100000000000000000000000
1111111333300001100000000000000033333111
1111111000000000000000000000000000000111
1111111000000000000000000000000000000111
1111111000000000000000000000000000000111
1111111000000000000000000000000000000111
1111111111111111111111111111111111111111
1111111111111111111111111111111111111111
1111111111111111111111111111111111111111
1111111111111111111111111111111111111111
1111111111111111111111111111111111111111
1111111111111111111111111111111111111111
1111111111111111111111111111111111111111
1111111111111111111111111111111111111111
