0000000000000000000000000000000000000000
0000000000000000000000000000000000000000
0000000000000000000000000000000000000000
0000000000000000000000000000000000000000
0000000000000000000000000000000000000000
0000000000000000000000000000000000000000
0000000000000000000000000000000000000000
0000000000000000000000000000000000000000
0000000000000000000000000000000000000000
0000000000000000000000000000000000000000
0000000000000000000000000000000000000000
0000000000000000000000000000000000000000
0000000000000000000000000000000000000000
0001100000000000000000000000000000000000
0001111000000000000000000000000000000000
0001111000000000000000000000000000000000
0001111111000001113333000000000000000000
0000111111111111110000000000000000000000
0000000011111111000000000000000000000000
0000000000000000000000000000111100000000
0000000000000000000000000000111100000000
0000000000000000000000000001111100000000
0000000000000000000000001111111110000000
0000000000000000000000011111111110000000
0000000000000000000001111111111110000000
0000000000000000000001111111111110000000
0000000000000000000001111111111110000000
0000000000000000001111111111111111000000
0000000000000000111111111111111111000000
0000000000001111111111111111111111000000
0000000011111111111111111111111111100000
0000011111111111111111111111111111100000
1111111111111111111111111111111111111111
1111111111111111111111111111111111111111
1111111111111111111111111111111111111111
1111111111111111111111111111111111111111
1111111111111111111111111111111111111111
1111111111111111111111111111111111111111
1111111111111111111111111111111111111111
1111111111111111111111111111111111111111
