0000000000000000000000000000000000000000
0000000000000000000000000000000000000000
0000000000000000000000000000000000000000
0000000000000000000000000000000000000000
0000000000000000000000000000000000000000
0000000000000000000000000000000000000000
0000000000000000000000000000000000000000
0000000000000000000000000000000000000000
0000000000000000000000000000000000000000
0000000000000000000000000000000000000000
0000000000000000000000000000000000000000
0000000000000000000000000000000000000000
0000000000000000000000000000001110000000
0000000000000000000000000000011110000000
0000000000000000000000000001111110000000
0000000000000000000000000001111110000000
0000000000000000000000000001111113330000
0000000000000000011100000001111110000000
0000000000000000011100000001111110000000
0000000000000011111100000001111110000000
0000000000000011111100000001111110000000
0000000000000011111100000001111110000000
0000111000000011111100000001111110000000
0000111000000011111100000001111111111111
0011111000000011111100000001111111111111
0011111000000011111111111111111111111111
1111111000000011111111111111111111111111
1111111000000011111111111111111111111111
1111111000000011111111111111111111111111
1111111000000011111111111111111111111111
1111111111111111111111111111111111111111
1111111111111111111111111111111111111111
1111111111111111111111111111111111111111
1111111111111111111111111111111111111111
1111111111111111111111111111111111111111
1111111111111111111111111111111111111111
1111111111111111111111111111111111111111
1111111111111111111111111111111111111111
1111111111111111111111111111111111111111
1111111111111111111111111111111111111111