0000000000000000000000000000000000000000
0000000000000000000000000000000000000000
0000000000000000000000000000000000000000
0000000000000000000000000000000000000000
0000000000000000000000000000000000000000
0000000000000000000000000000000000000000
0000000000000000000000000000000000000000
0000000000000000000000000000000000000000
0000000000000000000000000000000000000000
0000000000000000000000000000000000000000
0000000000000000000000000000000000000000
0000000000000000000033333300000000000000
0000000000000000000000000000000000000000
0000000000000000000000000000000000000000
0000000000000000000000000000000000000000
0000000000000000000000000000000000000000
0000000000000000000000000000000000000000
0000000000033333300000011111111100000000
0000000000000000000000011111111100000000
0000000000000000000000011111111100000000
0000000000000000000000011111111100000000
0000000000000000000000011111111100000000
0000000000000000000000011111111100000000
0000333333000000000000011111111100000000
0000000000000000000000011111111100000000
0000000000000000000000011111111100000000
0000000000000000000000011111111111111111
0000000000000000000000011111111111111111
0000000000000000000000011111111111111111
0000000000000000000000011111111111111111
0111111111111111111111111111111111111111
1111111111111111111111111111111111111111
1111111111111111111111111111111111111111
1111111111111111111111111111111111111111
1111111111111111111111111111111111111111
1111111111111111111111111111111111111111
1111111111111111111111111111111111111111
1111111111111111111111111111111111111111
1111111111111111111111111111111111111111
1111111111111111111111111111111111111111
